....................
.e3..e3..E5..e3..e3.
....................
...E4....E5....E4...
....................
.e3..e3..E5..e3..e3.
....................
....................
....................
....................
....................
..2332..2332..2332..
..3..3..3..3..3..3..
....................
....................
Speed: 15 8
Name:Well Prepared