....................
.e1...e2....E1...E2.
....................
.e1...e2....E1...E2.
....................
.e1...e2....E1...E2.
....................
.e1...e2....E1...E2.
....................
....................
....................
....................
.1234..........4567.
.4321..........7654.
....................
Speed: 0 0
Name:Shooting Range