....................
....................
...e3.e3.e3.e3.e3...
4.E4.E4.E4E4.E4.E4.4
4..E4.E4.E4.E4.E4..4
4.1.1.1.1.1.1.1.1..4
4..1.1.1.1.1.1.1.1.4
4.1.1.1.1.1.1.1.1..4
4..1.1.1.1.1.1.1.1.4
4..................4
4..................4
4..................4
4..................4
4..................4
4..................4
Speed: 20 8
Name:Tearing Through