....................
....................
..e6e6E4E4E4E4e6e6..
.e6e6e6E4E4E4e6e6e6.
....................
....................
....................
....................
....................
....................
41122334444443322114
41122334444443322114
41122334444443322114
41122334444443322114
....................
Speed: 20 5
Name:Petard Hoist
