....................
..e1e1..e1e1..e1e1..
....................
..e1e1..e1e1..e1e1..
....................
..e1e1..e1e1..e1e1..
....................
..e1e1..e1e1..e1e1..
....................
..e1e1..e1e1..e1e1..
....................
....................
....................
..3443..3443..3443..
....................
Speed: 20 3
Name:Great Numbers