....................
....................
....................
..E3E4E4E4E4E4E4E3..
.E3E4E4E4E4E4E4E4E3.
....................
....................
....................
....................
....................
....................
42334444444444443324
42334444444444443324
42334444444444443324
....................
Speed: 15 8
Name:Petard Hoist