....................
..e1e1...E3...e1e1..
....................
..e1e1...E3...e1e1..
....................
..e1e1...E3...e1e1..
....................
..e1e1...E3...e1e1..
....................
....................
....................
....................
....................
.44..44..44..44..44.
....................
Speed: 20 5
Name:Hardened Core