Speed:
....................
.e1e1e1.e1e1.e1e1e1.
....................
.e1e1e1.e1e1.e1e1e1.
....................
.e1e1e1.e1e1.e1e1e1.
....................
.e1e1e1.e1e1.e1e1e1.
....................
....................
....................
....................
..4444..4444..4444..
....................
....................