....................
..E4E4E4E4E4E4E4E4..
.E3E3E3E3E3E3E3E3E3.
..E2E2E2E2E2E2E2E2..
.e2e2e2e2e2e2e2e2e2.
..e2e2e2e2e2e2e2e2..
....................
.e2.e2.e2..e2.e2.e2.
....................
....................
....................
...44..44..44..44...
.444444444444444444.
.44..44..44..44..44.
....................
Speed: 5 2
Name:Barrage