.......E9E9E9.......
..E6E6E6E6E6E6E6E6..
.E4E4E4E4E4E4E4E4E4.
..E2E2E2E2E2E2E2E2..
.e2e2e2e2e2e2e2e2e2.
..e2e2e2e2e2e2e2e2..
....................
.e2.e2.e2..e2.e2.e2.
....................
....................
....................
...44..44..44..44...
.444444444444444444.
.44..44..44..44..44.
....................
Speed: 5 2
Name:Barrage
