....................
..e1e1...E2...e1e1..
....................
..e1e1...E2...e1e1..
....................
..e1e1...E2...e1e1..
....................
..e1e1...E2...e1e1..
....................
....................
....................
....................
....................
.44..44..44..44..44.
....................
Speed: 20 5
Name:Hardened Core