....................
.e3..e3......e3..e3.
.........E5.........
...E3..........E3...
.........E5.........
.e3..e3......e3..e3.
...e3....E5....e3...
....................
....................
....................
....................
....................
..2332..2332..2332..
..3..3..3..3..3..3..
....................
Speed: 15 5
Name:Reinforced