....................
..e1e1...e3...e1e1..
....................
..e1e1...e3...e1e1..
....................
..e1e1...e3...e1e1..
....................
..e1e1...e3...e1e1..
....................
....................
....................
....................
....................
.44..44..44..44..44.
....................