....................
....................
...e4e4e4e4e4e4e4...
4.E4E4E4E4E4E4E4E4.4
4..................4
4.1.1.1.1.1.1.1.1..4
4..1.1.1.1.1.1.1.1.4
4.1.1.1.1.1.1.1.1..4
4..1.1.1.1.1.1.1.1.4
4..................4
4..................4
4..................4
4..................4
4..................4
4..................4
Speed: 10 8
Name:Tearing Through