....................
..e1e1..e1e1..e1e1..
....................
..e1e1..e1e1..e1e1..
....................
..e1e1..e1e1..e1e1..
....................
..e1e1..e1e1..e1e1..
....................
..e1e1..e1e1..e1e1..
....................
....................
....................
...44....44....44...
....................
Speed: 10 5
Name:Great Numbers