....................
....................
..e6e6E4E4E4E4e6e6..
.e6e6e6E4E4E4e6e6e6.
....................
....................
....................
....................
....................
....................
....................
42234444444444443224
42234444444444443224
42234444444444443224
....................
Speed: 20 5
Name:Petard Hoist